11111111111111111111111111111111111111111111111111111111111111111111111111111111111111111111
10000000000000000000000000000C00011111111110000000000000CCC000000000000000000000000000000011
10000000000P000000111111111100000000000000000000E00000000000000000000000CC001111111111111111
11111111111111111111111111111111111111111111111111111111111111111111111111111111111111111111
