1111111111111111111111111111111
100001000CC0000000111C111000001
1P00000C00001001100000010000E01
1C00010001000000000C00000000C01
1111111111111111111111111111111
