11111111111111111111111111
100P001C000111100000000011
1C00C00000011000C000011001
10000000E000000111000CC001
11111111111111111111111111
