11111111111111111111111111
1000001C100111100000000011
1C00C01010011000C000011001
10000000E000000111000CC001
11111111111111111111111111
