11111111111111111111111111
100P001C100111100000000011
1C00C01110011000C000011001
10000000E000000111000CC001
11111111111111111111111111