111111111
1000C0001
1C0E00101
110000C01
100P00001
111111111
